#####################
#.          # #    .#
#    #####  # ##### #
####      @         #
##### ############# #
#.                 .#
#####################
