#################
#.        ..#   #
#.#.#.#.#.### # #
#     @       # #
############### #
#.....          #
#################
