###################
#@#       #.#     #
#   ##### #.##### #
#####.      #     #
#   # ##### ## ####
# ### # ..     #  #
#       ## ##     #
#########   ##### #
#....     #     . #
###################
